NO ./textures/walls/stone00.xpm
SO ./textures/walls/stone01.xpm
WE ./textures/walls/stone02.xpm
EA ./textures/walls/stone03.xpm

F 169,169,169
C 52,52,52

11111111111111111111111
10000000000000000000001
10000000000000000S00001
100000000000000000000001
111111111111111111111111
