NO ./textures/walls/stone00.xpm
SO ./textures/walls/stone01.xpm
WE ./textures/walls/stone02.xpm
EA ./textures/walls/stone03.xpm

F 169,169,169
C 52,52,52

11111111111111111111111111111111111111111111111111111111111111111111111
10100000000000000000000000000000000000000000000000000000000000000000001
10D01111111D1111111111D11111111D11111111111D1111111111111D1111111110111
10100000000001010001000111111110001000100010100000000000000000000000001
10111011111111000100010000000000100010001000100000000000000000000000001
10D0101000100011111D11111D11111111111111111D1D1111111111111111111111101
10101000100010000000000000100100000000000000000000000000000000000000001
10101111111D1D11111D111D1D11D11D1D1D1D1D1D1D1D11D11D1D1D1D11111D1D11101
101000000010D010D010D010D0100010D010D010D010D010D010D010D010D010D010D01
10D10000001010101010101010101010101010101010101010101010101010101010101
101111111D1010101010101010101010101010101010101010101010101010101010101
1010001D101010101010101010101010101010101010101010101010101010101010101
10D01010101010101010101010101010101010101010101010101010101010101000101
1NT100D0D0D010D010D010D010D010D010D010D010D010D010D010D010D010D01D11D01
11111111111111111111111111111111111111111111111111111111111111111111111
