NO ./textures/klimt/adele.xpm
SO ./textures/klimt/judith.xpm
WE ./textures/klimt/kiss.xpm
EA ./textures/klimt/lady.xpm

F 3,3,30
C 0,0,55

1111111111111111111111111
10E0000000000111000000001
1000000100000001100000001
1000011000000000000000001
1000000000111111111000001
1000000000100000000000001
1000000000100000110000001
1000010000111111111100001
1000110000100000000100001
1000011000100010000100001
1000000000100000000100001
100000000011111D111100001
1000100000000000000000001
1000110000000000000110001
1000000000000000000000001
111111111111111111D111111
1000000000000000000001001
1000011111111100000001001
10000D0000000100001000001
10000100000T0111111000001
1000010000000100000000001
1111111111111111111111111
