NO ./textures/walls/stone00.xpm
SO ./textures/walls/stone01.xpm
WE ./textures/walls/stone02.xpm
EA ./textures/walls/stone03.xpm

F 169,169,169

C 52,52,52
 
                 11111
                100001
1111111111111111001101
1000100000000000000001
1000100000000000000001
10001000W000010000001
10000000000001000001
100000000000010000001
 1111111111111111111
 
 
11
101
1001
1111           11
              1001
              1001
               11
