NO ./textures/test/north.xpm
SO ./textures/test/south.xpm
WE ./textures/test/west.xpm
EA ./textures/test/east.xpm

F 169,169,169
C 52,52,52
                  11
                 100001
 1111111111111111001101
1000100000000000000001
1000100000000000000001
10001000W000010000001
10000000000001000001
100000000000010000001
 1110111111111111111
    1

11
101
1001
1111          111
              1001
              1001
               11
