NO ./path_to_the_north_texture
SO ./path_to_the_south_texture
WE ./path_to_the_west_texture
EA ./path_to_the_east_texture

F 220,100,0
C 225,30,0
                  1111
                 100001
 1111111111111111001101
1000000000000000000001
 11101111111111111111
    1

11
101
1001
1111          111
              1001
              1E01
               11
