NO ./textures/test/north.xpm
SO ./textures/test/south.xpm
WE ./textures/test/west.xpm
EA ./textures/test/east.xpm

F 169,169,169
C 52,52,52

11111111111111111      111
10000000000000001     10001
 1000000000S000001111100001
 10000000000000000000000001
 1000000000000000000000011
  100000022222211100000001
   1000001       10000001
   1000001       10000001
   100001111111111000001
   100000000000000000001
    1000000000000000111
     1111111111211000111111111111
     10000000000000000000000000001
     10000000000000000000000000001
     10000000000000000000000000001
     10000000000000000000000000001
     10000000000111111111110000001
     100000000001          1000001
     1000000000011111111111100001
     100000000001000000000000001
     10000000000100000000000001
      111111111111111111111111
